400
0
380
10 13 5 5 4 5 5 5 7 12 5 5 5 5 5 4 5 5 5 6
8 5 5 5 3 12 5 5 5 3 13 5 5 5 6 10 12 5 5 3
8 5 5 5 5 3 13 5 5 5 5 5 5 6 10 9 1 5 5 6
10 13 5 5 4 5 5 5 5 5 5 5 6 10 9 5 5 4 5 2
8 5 5 6 9 5 5 5 5 5 5 5 2 9 5 5 5 1 6 10
8 5 7 9 5 5 5 5 5 4 5 7 9 5 5 5 5 6 11 10
10 12 4 5 6 13 4 5 7 9 5 5 5 5 5 7 12 1 5 2
10 10 10 14 10 14 9 5 5 4 4 5 4 5 5 6 10 12 6 10
10 10 10 10 10 9 5 5 5 3 8 6 8 5 6 10 10 11 10 11
10 11 10 10 10 12 5 5 5 7 10 8 1 6 10 8 1 5 1 6
8 5 6 9 2 9 5 5 5 5 3 8 5 3 10 10 13 5 6 10
8 13 5 5 1 6 12 5 5 5 5 1 5 7 8 1 5 5 3 10
10 13 4 5 6 10 9 5 5 5 5 6 12 4 2 6 5 5 5 3
9 6 10 14 10 9 6 12 5 4 5 3 10 10 11 10 13 4 5 6
13 3 10 10 9 5 3 9 7 10 12 5 2 8 4 1 5 3 14 10
12 5 3 8 5 5 5 5 5 3 8 6 11 10 9 5 5 5 3 10
10 12 5 1 5 7 12 5 5 5 3 8 7 9 5 6 12 5 5 3
10 9 5 5 5 7 10 6 5 5 6 8 5 7 12 3 10 12 6 14
10 13 5 5 5 5 3 10 13 6 10 9 5 5 3 12 3 11 10 10
9 5 5 5 5 5 5 1 5 3 9 5 5 5 5 1 5 5 1 3